//MAP CONVERTED BY dmm2tgm.py THIS HEADER COMMENT PREVENTS RECONVERSION, DO NOT REMOVE
"ac" = (
/turf/closed/wall/r_wall/bunker,
/area/event)
"bF" = (
/obj/structure/flora/jungle/planttop1,
/turf/open/gm/grass/grass1,
/area/event)
"bS" = (
/obj/structure/flora/bush/ausbushes/var3/sunnybush{
	icon_state = "fernybush_2";
	pixel_y = 10
	},
/turf/open/gm/grass/grass1,
/area/event)
"eM" = (
/obj/structure/flora/bush/ausbushes/var3/sunnybush{
	desc = "The oranges aren't done yet... this sucks.";
	name = "orange tree";
	pixel_x = -7;
	pixel_y = 10
	},
/turf/open/gm/grass/grass1,
/area/event)
"eY" = (
/obj/structure/item_purchase/door{
	door_id = 1
	},
/turf/open/floor/white,
/area/event)
"fQ" = (
/obj/structure/item_purchase/door{
	door_id = 2
	},
/turf/open/floor/white,
/area/event)
"iY" = (
/obj/structure/item_purchase/m39,
/turf/open/floor/white,
/area/event)
"ju" = (
/obj/structure/item_purchase/door{
	door_id = 7
	},
/turf/open/floor/green/northwest,
/area/event)
"jK" = (
/obj/structure/item_purchase/hedp,
/turf/open/floor/whitepurplecorner/east,
/area/event)
"mH" = (
/obj/structure/flora/jungle/vines/light_2,
/turf/open/gm/grass/grass1,
/area/event)
"mJ" = (
/obj/effect/landmark/horde_mode/marinespawn,
/obj/effect/landmark/horde_mode/marinespawn,
/turf/open/floor/dark,
/area/event)
"op" = (
/obj/structure/blocker/forcefield/human,
/turf/open/floor/whitepurplecorner/east,
/area/event)
"oE" = (
/obj/structure/item_purchase/door{
	door_id = 5
	},
/turf/open/floor/white,
/area/event)
"to" = (
/obj/structure/item_purchase/perk_machine/explosive_resistance,
/turf/open/floor/brown/northwest,
/area/event)
"zk" = (
/turf/open/gm/dirtgrassborder/grassdirt_corner2/south_west,
/area/event)
"zr" = (
/obj/structure/item_purchase/gear,
/turf/open/floor/brown/northwest,
/area/event)
"zW" = (
/obj/effect/landmark/late_join,
/turf/open/floor/white,
/area/event)
"Av" = (
/obj/structure/flora/jungle/vines/light_1,
/turf/open/gm/grass/grass1,
/area/event)
"Ci" = (
/obj/structure/item_purchase/ammo_refill,
/turf/open/floor/dark,
/area/event)
"Ck" = (
/obj/structure/item_purchase/ammo_refill,
/turf/open/floor/green/northwest,
/area/event)
"Cq" = (
/obj/structure/item_purchase/machete,
/turf/open/gm/grass/grass1,
/area/event)
"Cv" = (
/turf/open/gm/dirtgrassborder/grassdirt_corner/south_west,
/area/event)
"CD" = (
/obj/structure/item_purchase/abr40,
/turf/open/floor/dark,
/area/event)
"CK" = (
/obj/effect/landmark/horde_mode/marinespawn,
/turf/open/floor/dark,
/area/event)
"CZ" = (
/obj/structure/item_purchase/door{
	door_id = 6
	},
/turf/open/floor/green/northwest,
/area/event)
"DH" = (
/obj/structure/flora/jungle/vines/light_3,
/turf/open/gm/grass/grass1,
/area/event)
"Eb" = (
/obj/structure/item_purchase/door,
/turf/open/floor/white,
/area/event)
"Ej" = (
/turf/open/floor/white,
/area/event)
"Fx" = (
/turf/closed/wall/strata_ice/jungle,
/area/event)
"Fy" = (
/turf/open/floor/dark,
/area/event)
"GO" = (
/obj/structure/item_purchase/door{
	door_id = 4
	},
/turf/open/floor/brown/northwest,
/area/event)
"Hl" = (
/obj/structure/item_purchase/injector_refill,
/turf/closed/wall/r_wall/bunker,
/area/event)
"Hw" = (
/obj/structure/blocker/forcefield/human,
/turf/open/floor/brown/northwest,
/area/event)
"HZ" = (
/obj/effect/landmark/horde_mode/xenospawn,
/turf/open/gm/grass/grass1,
/area/event)
"JS" = (
/turf/open/floor/green/northwest,
/area/event)
"KG" = (
/obj/structure/item_purchase/door{
	door_id = 3
	},
/turf/open/floor/whitepurplecorner/east,
/area/event)
"Lc" = (
/obj/structure/flora/bush/ausbushes/var3/sunnybush,
/turf/open/gm/grass/grass1,
/area/event)
"Mc" = (
/obj/structure/item_purchase/m41a,
/turf/open/floor/brown/northwest,
/area/event)
"ME" = (
/obj/structure/flora/jungle/plantbot1,
/turf/open/gm/grass/grass1,
/area/event)
"Nj" = (
/turf/open/floor/brown/northwest,
/area/event)
"Ou" = (
/obj/structure/flora/jungle/vines/heavy,
/turf/open/gm/grass/grass1,
/area/event)
"OD" = (
/obj/structure/mystery_purchase/weapons,
/turf/open/gm/dirt,
/area/event)
"OH" = (
/obj/structure/item_purchase/perk_machine/speed,
/turf/open/floor/whitepurplecorner/east,
/area/event)
"OK" = (
/obj/structure/blocker/forcefield/human,
/obj/structure/flora/jungle/vines/heavy,
/turf/open/gm/grass/grass1,
/area/event)
"Pf" = (
/obj/structure/flora/bush/ausbushes/var3/fullgrass,
/turf/open/gm/dirt,
/area/event)
"QH" = (
/obj/structure/blocker/forcefield/human,
/turf/open/gm/grass/grass1,
/area/event)
"Sj" = (
/turf/open/floor/whitepurplecorner/east,
/area/event)
"UX" = (
/obj/effect/landmark/observer_start,
/turf/open/floor/white,
/area/event)
"UY" = (
/obj/structure/item_purchase/sentry,
/turf/open/floor/whitepurplecorner/east,
/area/event)
"VK" = (
/obj/structure/item_purchase/perk_machine,
/turf/open/floor/green/northwest,
/area/event)
"XB" = (
/turf/open/gm/dirt,
/area/event)
"Yq" = (
/obj/structure/item_purchase/firstaid,
/turf/open/floor/white,
/area/event)
"ZN" = (
/turf/open/gm/grass/grass1,
/area/event)

(1,1,1) = {"
Fx
Fx
Fx
Fx
Fx
Fx
Fx
Fx
Fx
Fx
Fx
Fx
ac
ac
ac
ac
ac
ac
ac
ac
Fx
Fx
Fx
Fx
Fx
Fx
Fx
Fx
Fx
Fx
Fx
Fx
"}
(2,1,1) = {"
Fx
ZN
ZN
ZN
ZN
ZN
ZN
ZN
ZN
ZN
ZN
ZN
ac
Fy
Fy
Fy
CD
Fy
Fy
ac
ZN
ZN
ZN
ZN
ZN
ZN
ZN
ZN
ZN
ZN
ZN
Fx
"}
(3,1,1) = {"
Fx
ZN
HZ
ZN
ZN
ZN
ZN
ZN
ZN
ZN
ZN
ZN
ac
Fy
Fy
Fy
Fy
Fy
Fy
ac
ZN
ZN
ZN
ZN
ZN
ZN
HZ
ZN
ZN
ZN
ZN
Fx
"}
(4,1,1) = {"
Fx
ZN
ZN
ZN
ZN
HZ
ZN
ZN
ZN
ZN
ZN
ZN
QH
Fy
Fy
CK
CK
Fy
Fy
QH
ZN
ZN
ZN
ZN
ZN
ZN
ZN
ZN
ZN
ZN
ZN
Fx
"}
(5,1,1) = {"
Fx
ZN
ZN
ZN
ZN
ZN
ZN
ZN
ZN
ZN
ZN
ZN
ac
Fy
Fy
Fy
Fy
Fy
Fy
ac
ZN
ZN
ZN
ZN
ZN
ZN
ZN
ZN
ZN
ZN
ZN
Fx
"}
(6,1,1) = {"
Fx
ZN
ZN
ZN
ZN
ZN
ZN
ZN
ZN
ZN
ZN
ZN
ac
Fy
Fy
ac
ac
Fy
Fy
ac
ZN
ZN
ZN
ZN
ZN
ZN
ZN
ZN
ZN
HZ
ZN
Fx
"}
(7,1,1) = {"
Fx
ZN
ZN
ZN
ZN
ZN
ZN
ZN
ZN
ZN
ZN
ZN
ac
Fy
Fy
ac
ac
Fy
Fy
ac
ZN
ZN
ZN
ZN
ZN
ZN
ZN
ZN
ZN
ZN
ZN
Fx
"}
(8,1,1) = {"
Fx
ZN
HZ
ZN
ZN
ZN
ZN
ZN
ZN
ZN
ZN
ZN
ac
Fy
Fy
Fy
Fy
Fy
Fy
ac
ZN
ZN
ZN
ZN
ZN
ZN
ZN
ZN
ZN
ZN
ZN
Fx
"}
(9,1,1) = {"
Fx
ZN
ZN
ZN
ZN
ZN
ZN
ZN
ZN
ZN
ZN
ZN
QH
Fy
Fy
CK
mJ
Fy
Fy
QH
ZN
ZN
ZN
ZN
ZN
ZN
ZN
ZN
ZN
ZN
ZN
Fx
"}
(10,1,1) = {"
Fx
ZN
ZN
ZN
ZN
ZN
ZN
ZN
ZN
ZN
ZN
ZN
ac
Fy
Fy
Fy
Fy
Fy
Fy
ac
ZN
ZN
ZN
ZN
ZN
ZN
ZN
ZN
ZN
ZN
ZN
Fx
"}
(11,1,1) = {"
Fx
ZN
ZN
ZN
ZN
ZN
ZN
ZN
ZN
ZN
ZN
ZN
ac
Fy
Fy
Fy
Fy
Fy
Ci
ac
ZN
ZN
ZN
ZN
ZN
ZN
ZN
ZN
ZN
ZN
ZN
Fx
"}
(12,1,1) = {"
ac
ac
ac
Hw
Hw
Hw
ac
ac
ZN
ZN
ZN
ZN
ac
ac
ac
Eb
Eb
ac
ac
ac
ZN
ZN
ZN
ZN
ZN
ZN
ZN
ZN
ZN
ZN
ZN
Fx
"}
(13,1,1) = {"
ac
to
Nj
Nj
Nj
Nj
Nj
ac
ZN
ZN
ZN
ZN
ZN
ac
Ej
Ej
Ej
Ej
ac
ZN
ZN
ZN
ac
OK
OK
ac
ac
op
ac
op
ac
ac
"}
(14,1,1) = {"
ac
Nj
Nj
Nj
Nj
Nj
Nj
ac
ac
ac
ZN
ZN
ac
ac
Ej
Ej
Ej
Ej
ac
ac
ZN
ZN
ac
Ou
Av
ac
Sj
Sj
Sj
Sj
Sj
ac
"}
(15,1,1) = {"
ac
Nj
Nj
Nj
Nj
Nj
Nj
Nj
zr
ac
ZN
ac
Hl
Ej
Ej
Ej
Ej
Ej
Ej
ac
ac
ZN
ac
Av
DH
ac
Sj
Sj
Sj
Sj
Sj
ac
"}
(16,1,1) = {"
ac
Nj
Nj
Nj
Nj
Nj
Nj
Nj
Nj
ac
ac
ac
Ej
Ej
Ej
Ej
Ej
Ej
Ej
Yq
ac
ac
ac
DH
ZN
ac
Sj
Sj
Sj
Sj
Sj
ac
"}
(17,1,1) = {"
ac
Nj
Nj
Nj
Nj
Nj
Nj
Nj
Nj
ac
Ej
Ej
Ej
Ej
Ej
Ej
Ej
Ej
Ej
Ej
Ej
Ej
ac
ZN
DH
ac
Sj
Sj
Sj
Sj
Sj
ac
"}
(18,1,1) = {"
ac
Mc
Nj
Nj
Nj
Nj
Nj
Nj
Nj
eY
Ej
Ej
Ej
Ej
Ej
Ej
zW
Ej
Ej
Ej
Ej
Ej
fQ
ZN
ZN
KG
Sj
Sj
Sj
Sj
Sj
ac
"}
(19,1,1) = {"
ac
Nj
Nj
Nj
Nj
Nj
Nj
Nj
Nj
eY
Ej
Ej
Ej
Ej
Ej
Ej
UX
Ej
Ej
Ej
Ej
Ej
fQ
ZN
ZN
KG
Sj
Sj
Sj
Sj
OH
ac
"}
(20,1,1) = {"
ac
Nj
Nj
Nj
Nj
Nj
Nj
Nj
Nj
ac
Ej
Ej
Ej
Ej
Ej
Ej
Ej
Ej
Ej
Ej
Ej
Ej
ac
ZN
ZN
ac
Sj
Sj
Sj
Sj
Sj
ac
"}
(21,1,1) = {"
ac
Nj
Nj
Nj
Nj
Nj
Nj
Nj
Nj
ac
ac
ac
Ej
Ej
Ej
Ej
Ej
Ej
Ej
Ej
ac
ac
ac
DH
ZN
ac
Sj
Sj
ac
Sj
Sj
ac
"}
(22,1,1) = {"
ac
ac
Hw
Hw
ac
ac
Nj
Nj
Nj
ac
Av
ac
ac
iY
Ej
Ej
Ej
Ej
Ej
ac
ac
Ou
mH
ZN
ZN
ac
Sj
ac
ac
ac
Sj
ac
"}
(23,1,1) = {"
Fx
ZN
ZN
ZN
ZN
ac
Nj
Nj
Nj
ac
ZN
mH
ac
ac
Ej
Ej
Ej
Ej
ac
ac
Ou
mH
DH
ZN
Cq
ac
Sj
Sj
ac
Sj
Sj
ac
"}
(24,1,1) = {"
Fx
DH
bF
ME
ZN
ac
ac
GO
GO
ac
mH
mH
Av
ac
Ej
Ej
Ej
Ej
ac
Ou
Ou
Ou
mH
ZN
DH
ac
Sj
Sj
Sj
Sj
Sj
ac
"}
(25,1,1) = {"
Fx
ZN
ZN
ZN
ZN
bS
ZN
ZN
ZN
ZN
ZN
ZN
mH
ac
ac
oE
oE
ac
ac
ac
Hl
ac
ac
ZN
ZN
ac
Sj
Sj
Sj
Sj
Sj
ac
"}
(26,1,1) = {"
Fx
ZN
DH
ZN
ZN
ZN
ZN
ZN
ZN
ZN
ZN
eM
ZN
ac
JS
JS
JS
JS
JS
JS
JS
Ck
ac
DH
ZN
ac
Sj
Sj
Sj
Sj
Sj
ac
"}
(27,1,1) = {"
Fx
DH
DH
ZN
ZN
ZN
ZN
ZN
ZN
ZN
ZN
ZN
ZN
ac
JS
JS
JS
JS
JS
JS
JS
JS
ac
ZN
ZN
ac
Sj
Sj
Sj
Sj
Sj
ac
"}
(28,1,1) = {"
Fx
Fx
Fx
Cv
Lc
ZN
ZN
ZN
ZN
Lc
ZN
ZN
ZN
ju
JS
JS
JS
JS
JS
JS
JS
JS
CZ
ZN
ZN
KG
Sj
Sj
Sj
Sj
Sj
ac
"}
(29,1,1) = {"
Fx
Fx
XB
zk
Cv
ZN
ZN
ZN
ZN
ZN
ZN
ZN
ZN
ju
JS
JS
JS
JS
JS
JS
JS
JS
CZ
ZN
ZN
KG
Sj
Sj
Sj
Sj
Sj
ac
"}
(30,1,1) = {"
Fx
Pf
OD
XB
zk
Fx
Ou
ZN
ZN
ZN
bF
ME
ZN
ac
JS
JS
JS
JS
JS
JS
JS
JS
ac
DH
ZN
ac
Sj
Sj
Sj
Sj
Sj
ac
"}
(31,1,1) = {"
Fx
XB
XB
Pf
Fx
Fx
mH
DH
ZN
ZN
ZN
ZN
ZN
ac
JS
JS
JS
VK
JS
JS
JS
JS
ac
Av
DH
ac
UY
Sj
Sj
Sj
jK
ac
"}
(32,1,1) = {"
Fx
Fx
Fx
Fx
Fx
Fx
Fx
Fx
Fx
Fx
Fx
Fx
Fx
ac
ac
ac
ac
ac
ac
ac
ac
ac
ac
Fx
Fx
ac
ac
ac
ac
ac
ac
ac
"}
